Miss Gaskill - пані Ґаскілл
Arthur Morgan- Артур Морґан
Davey - Дейві
Jenny - Дженні
Sean - Шон
Mac - Мак
Mr. Pearson - Пан Пірстон
Miss Grimshaw - Пані Ґрімшо
Charles Smith - Чарльз Сміт
Pinkertons - Пінкертони
Jenny - Дженні
Billy - Біллі
Colm - Кольм
О'Driscoll - О'Дрісколл
Uncle Sam - Дядько Сем
Jack Marston - Джек Марстон
Sadie Adler - Седі Адлер
Jake - Джейк
Leila Stetson - Лейла Стентсон
Tilly - Тіллі
Karen - Карен
O'Shea - О'ші
Mecah Bell - Міка Белл
Bill Williamson - Білл Віллямс
Uncle - Дядечко - Дядько або Старий
Javier Escuella - Хав'єр Ескуела
Leopold Strauss - Леопольд Штраус
Molly - Моллі
Mary-Beth - Мері-Бет
John Marston - Джон Марстон
Annabelle - Анабель
Lenny Summers - Лені Саммерс
Leviticus Cornwall - Левіт Корнволл
Kieran Duffy - Кіран Даффі
Hosea - Хозія
